11111111111111111111
10000000000000000001
11100000000000000001
10000000000000000001
10000111000000000001
10000101000000000001
10000111000000000001
1000000C000000000001
100000P0000000000001
10000000000000000001
10000000E00000000001
10000000000000000001
11111111111111111111
11100000000000000111
11111111111111111111