11111111111111111111
11111111111111111111
11111111111111111111
11111111111111111111
11111111111111111111
11111111111111111111
11111111111111111111
11E11111111111111111
11011111111111111111
11011111111111111111
100000000000000000C1
11111111111101111111
10P00000000000000001
11111111111111111111