1111111111111111111111111111111111111111
1000000000000000000000000000000000000001
1110000000000000000000000000000000000001
1000000000000000000000000000000000000001
1000000000000000000000000000000000000001
1000000000000000000000000111000000000001
1000000000000000000000000101000000000001
1000000000000000000000000111000000000001
1000000C00000000000000000000000000000001
1000000000000000000000000000000000000001
100000000000000000000P000000000000000001
1000000000000000000000000000000000000001
1000000000000000000000000000000000000001
10000000000000000000000000E0000000000001
1000000000000000000000000000000000000001
1111111111111111111111111111111111111111
1111111111111111111111111111111111111111
1110000000000000000000000000000000000111
1111111111111111111111111111111111111111
1111111111111111111111111111111111111111